20 20
...##############.##
.#....#...........##
..#...#.....#....##.
...#......####.....#
#...#.....##########
#..................#
#..................#
#..#...............#
..###..............#
#..................#
#.#.#.#.#.#.#.#.#.#.
....................
.#.#.#.#.#.#.#.#.#.#
....................
####.....####....###
....###.......#....#
#.................##
###.........###.#.#.
....................
####################
